DATA JAWABAN KUIS PSIKOLOGI DAN FILOSOFI
==================================================


[JAWABAN BARU - 2025-07-31 19:55:51]
HASIL KUIS KEPRIBADIAN LENGKAP | Format: Pertanyaan: Jawaban_User
=====================================

BAGIAN I: TES KEPRIBADIAN
1. Anda rutin mendapatkan teman baru: Setuju

2. Ide-ide kompleks dan baru lebih membuat Anda bersemangat: Setuju

3. Lebih terpengaruh oleh resonansi emosional daripada argumen faktual: Tidak Setuju

4. Ruang hidup dan kerja bersih dan terorganisir: Tidak Setuju

5. Tetap tenang dalam banyak tekanan: Tidak Setuju

6. Berjejaring dengan orang asing terasa menakutkan: Setuju

BAGIAN II: TES MBTI
1. Bertemu orang baru: Memulai membuka topik pembicaraan.

2. Pekerjaan menghadapi banyak orang baru: Merasa tertekan.

3. Pilihan pertemanan: Banyak teman walaupun jarang bertemu.

4. Peran dalam kelompok: 'Tempat' curhat karena dianggap merupakan pendengar yang baik.

5. Ketika ada masalah: Memilih untuk memendamnya.

6. Ketika ada gosip baru: Tidak terlalu peduli.

7. Bertemu orang baru (pembicaraan): Sulit mencari topik pembicaraan dan biasanya pembicaraan tidak bertahan lama.

8. Berbicara di depan publik: Melatih apa yang ingin dibicarakan beberapa kali sebelum acara berlangsung.

9. Mendatangi pesta: Memilih untuk pulang lebih awal karena merasa semakin lelah.

10. Tidak suka pada seseorang: Langsung mengomunikasikan kepada orang tersebut.

11. Yang lebih dipercayai: Intuisi

12. Pilihan judul buku: "Cara Praktis Menjadi Kaya dalam Waktu 1 Bulan"

BAGIAN III: PERTANYAAN PSIKOLOGI
1. Reaksi terhadap kegagalan besar: Mencari kesalahan pada orang lain atau faktor eksternal untuk menjelaskan kegagalan tersebut.

2. Hal yang ingin diubah dari masa lalu: Hubungan yang rusak atau konflik yang belum terselesaikan.

3. Kebutuhan saat merasa rentan: Ruang dan waktu untuk memproses emosi sendiri tanpa interupsi.

BAGIAN IV: PERTANYAAN FILOSOFI
1. Tujuan utama kehidupan manusia: Mencapai potensi tertinggi diri sendiri dan terus belajar.

2. Definisi keadilan dalam masyarakat: Sumber daya dan peluang didistribusikan secara merata untuk mengurangi ketimpangan.

3. Pilihan antara kebenaran dan ilusi: Mencari cara untuk menemukan kebenaran yang dapat diterima, meskipun itu berarti menghadapi kenyataan yang sulit.

4. Peran teknologi di masa depan: Sebagai potensi ancaman terhadap kemanusiaan jika tidak dikelola dengan bijak.

==================================================